AAAWWWWWWWWWWWWWWWWWWWWWWWWWWWWWWWWAAAAA
AAR                                LAAAA
AARoyTY                            LAAAA
AAATAAATTTTY  yTTTTY  yTTTTTTTTTY  LAAAA
AAAAACCAAAAR  LAAAAI  LAAAAAAAAAR  LAAAA
AAAAACBBAAAR  LAAAI   LAAAAAAAAAR  LAAAA
AAAAACBBAAAR  LAAR    LAAAWWWWWWI  LAAAA
AAAAAAWWAAAR  LAARZZZZLAAR         LAAAA
AAAAAR  LAAR  LAARZZZZLAAR  yY yTY LAAAA
AAABAR  LAAR  LAARZZZZLAAR  LR LAR LAAAA
AABBAR  XWWI  LAAATTTTAAAR  LR LAR LAAAA
AAAAAR    k   LAAAAAAAAAAR  LR LAI LAAAA
AAAAAATTTTTTTTAAAAAAAAAAAR  LR LR  LAAAA
AAWWWWWWWWWWWWAAAAAAAAAAAR  LR LR kLAAAA
ARO           LAAAAACCAAAR  LRnLR  LAAAA
AATTTTY       LAAAAACBBAAR  LATAATTAAAAA
AAAWWAR       LABBAABBBAAR  LAAAAAAAAAAA
AAR  LR      PLABCAABAAAAR  LAAAAAAAAAAA
AAR  LATTTTTTTAABCAAAAAAAR  LAAAAAAAAAAA
AAR  XWWWWWWWWWWWWWWWWWWWI  LAAAAABBAAAA
AAR    k                    LAAAAACCAAAA
AAR                         LAAAAADBBAAA
AAATTTTTTTTTTTTTTTTTTTTTTTTTAAAAAAAAAAAA



