DWWWWWWWWWWWWWWWWWAAAAAAAAAAAAAAAAAAAAAA
R      k          XWWWWWWWWWWWWWWWWWAAAA
R  yTTTY                       k    LAAA
R  LAAAR          yTTTTTTTY         LAAA
R  LBBBR          LABBDDDDR  yTTTY  LAAA
R nLCCCR          LABCBBBAR  XWWWI  LAAA
R  LADDR          LADDDDDDR    k    LAAA
R  LAAAR  yTTTY  yAAAWWWWWWTTTY   yTAAAA
R  LAAAR  LBAAR  LAAR     oXWWI   LAAAAA
R  LAAAR  LBABR  LBAR    yY       LABBBC
R  XWWWI  LBAAR  LBAR yY XI  yTTTTAAADAB
R         LCBBR  LAAR LR     XAAAWWWWWAA
R         LAAAR  LAAR LATTTY  LAI     LA
ATTTTTTY  LAAAR  LAAR LAAAAR  LR  yTY LA
AWWWDDDR  LAAAR  XAAR LDDDAAY XI  LAR XA
RZZZXWWI  XWAAR   XAR LDDDAAR     LAR  L
RZZZ        XWAR   XI LDDDAAATTTTTAAR  L
RZZZ     yY   LR      LAAAAAAWWWWWWWI  L
RZZZ     LR  OLATTTTY XWWWABR          L
RZZZyTTTTAATTTBBBBBBR  k  LAAY      yTTA
AY yWWWWWWWWWWWWWWWWI     LAAR  yY  LABD
BR                     yTTAAAR  LR PLABD
AATTTTTTTTTTTTTTTTTTTTTDDDDDDDTTAATTAABD