BBBWWWWWWWWWWWWWWWAAAAAAAAAAAAAAAAAAABBA
BBB               XAAAWWWWWWWWWWWWWWWWWA
BBR               oXWI            ZZZZZA
BBR  YTTTTTTTTTTTTR P LY  yTTTTTTYZZZZZA
BBR  LAAAAAAAAAAAAR   LR  LAAAAAAAZZZZZA
BBR  LAAAAAAAAAAAAR   LR  LAAAAAAAAAABBA
BBR  LAAAAAAAAAAAAR  yAR  LAAAAAAAAAABBA
BBR  LAAAAAAAAAAAAR  LAR  LAAAAAAWWWWAAA
BBR  LAAAAAAAAAAAAR  LAR  LAAAAAR    LAB
BBR  XWWWWWWWWWWWWI  LAR  LAAAAAR    XWB
BBR                  LAR  LAAAAAR      L
BAI  yTTTTTTTTTTTTTTTAAR  LAAAAAI   yY L
AR   LAAAAAAAAAAAAAAAAAR  LAAAAR  yTAR L
ARk  LAAAAWWWAAAAAAAAAAR  XWWWWI  LAAR L
BAY  LAAAR  kLAAAAAAAAAR         OLAAR L
BAR  LAAAR   LAAAAAAAAAR  yTTTTTTTAWWI L
CAR  LAAAI   LAAAAAAAAAR  LAAAAAAAR    L
CAR  LAAR  yTAAAAAAAAAAR  LAAAAAAAR  yTA
BAATTAAAR  LAAAAAAAAAAARk LAAAAAAAR  LAB
CAAWWAAAI  LAAAAAAAAAAAATTAAAAAAAAR  LAB
BBR nXWI    XWWWWWWWWWWWWWWWWWWWWWI  LAB
BBR                          k       LAB
BBBTTTTTTTTTTTTTTTTTTTTTTTTTTTTTTTTTTAAA